128;128
18;3;3;6
240,144;528,144|528,176;240,176|240,208;528,208|528,240;240,240
7;8|18;3
111111111111111111111111111111
111111111111111111111111111111
111111111111111111111111111111
111000111111111100000111111111
111000100000000001000111111111
111000100000000001000111111111
111000100000000001000111111111
111000100000000001000111111111
111000001111111111000111111111
111111111111111111111111111111
111111111111111111111111111111
111111111111111111111111111111
111111111111111111111111111111
111111111111111111111111111111
111111111111111111111111111111
111111111111111111111111111111
111111111111111111111111111111
111111111111111111111111111111
111111111111111111111111111111
111111111111111111111111111111